*)abanti/s	place
*(omhri/s	person
*(ippo/ths	group
*(elikwnia/des	group
*)/agrai	place
*)olumpiei=on	place
*)isokra/ths	person
*)ici/wn	person
*)asklhpiei=on	geog_name
*)asia/s	is_ethnic
*bohdro/mia	month
*)afrodi/sia	festival
*dwdwni/s	group
kuyeli/dai	group
*lw=|os	month
*lhtoi/dhs	person
*paia/n	title
*steirieu/s	ethnic
*parqisti/	language
*plagktai/	place
*tau/geton	place
*stoa/	place
*so/lwn	person
*(/arpuiai	group
*dio/skoroi	group
*skiroforiw/n	month
*sikeliw=tis	place
*si/bulla	group
*ba/kxeios	group
*ka/rneia	festival
*sfi/gc	group
*serapei=on	place
*septe/mbrios	month
*se/leukos	person
*saka/dhs	person
*koumano/s	person
*puqia/s	group
*politei/a	title
*pleia/s	constellation
*koru/dwn	person
*(hrippi/das	person
*pedieu/s	group
*dwri/maxos	person
*)anilai=os	person
*meiduli/dhs	person
*drosi/s	person
*drwpi/dhs	person
*eu)rubia/dhs	person
*fulh/	place
*pa=nes	group
*dionu/sia	festival
*panaqh/naia	festival
*xa/ris	group
*)/erwtes	group
*streyia/dhs	person
*gorgw/n	group
*tuxia/dhs	person
*ba/kxos	person
*kuni/skos	group
*kuniko/s	group
*mi/kullos	person
*moi=ra	group
*gi/gas	group
*(/uhttos	person
*me/gara/de	place
*poteidea/ths	ethnic
*qe/oklos	person
*quia/s	group
*sa/lmocis	person
*sa/bata	place
*sarma/ths	ethnic
*sisi/nnhs	person
*stumfali/s	ethnic
*sullai=os	person
*tarra/kwn	place
*tauro/polos	person
*xa/wn	ethnic
*matqi/as	person
*melani/wn	person
*mo/rswn	person
*mou/mmios	person
*na/balo	person
*narbwni=tis	place
*nasa/mwn	ethnic
*naxw/rhs	person
*nikaeu/s	ethnic
*niko/fhmos	person
*ou)a/rrwn	person
*panta/rkhs	person
*pa/ralos	group
*pasiklh=s	person
*pershi/s	person
*poluxa/rhs	person
*leu/kofrus	place
*ma/kar	place
*maih=tis	place
*maliako\n	place
*mana/hmos	person
*ka/is	person
*klei/twn	person
*kuti/nion	place
*kwpai/s	place
*braxma=nes	group
*canqiko/s	month
*darda/nios	ethnic
*dekeleiko/s	place
*didu/mh	place
*doli/wn	ethnic
*gara/mantes	ethnic
*ai)/geira	place
*ai)bou/tios	person
*boio/s	ethnic
*)ape/nnina	place
*)alpeina/	place
*)apenni=nos	place
*)/asanos	person
*)asamwnai=os	person
*)asfalti=tis	place
*)aza/hlos	person
*)epiknhmi/dioi	ethnic
*)eruqrai/	place
*(/alai	place
*(ragouh=los	person
*(raskou/polis	person
*(ublh/sios	person
*(uperberetai=os	month
*)/arxandros	person
*)/atus	person
*)abessai=os	person
*)agh/sarxos	person
*)agia/dhs	group
*)/abdhra	place
*fi/lippoi	place
*fla/uios	person
*folo/h	place
*ge/ssios	person
*gefurai=os	ethnic
*glauke/ths	person
*golo/sshs	person
*ka/ludnai	place
*kambu/los	person
*kerkuw/n	person
*krhtiko/s	place
*krotwnih=tai	ethnic
*mhnofa/nhs	person
*neemi/as	person
*ni/ger	person
*nwrbano/s	person
*pallhneu/s	ethnic
*)/adados	person
*parra/sios	ethnic
*pla/kidos	person
*qeai/dhtos	person
*)akro/lissos	place
*)asklhpia/dai	group
*)axito/felos	person
*)efu/roi	ethnic
*)ia/mneia	place
*)ie/bwsqos	person
*)iessai=os	person
*)indw=|os	ethnic
*)iwsafa/ths	person
*)oxozi/as	person
*ai)oliko/s	ethnic
*dw=ros	person
*eu)ce/nippos	person
*eu)meni/des	group
*faraw/qhs	person
*fh=stos	person
*kelainai/	place
*komaiqw/	person
*krh/thqen	place
*lafri/a	person
*maliako/s	place
*messa/pios	ethnic
*miqrada/ths	person
*mossu/noikoi	ethnic
*ou)/cios	ethnic
*ou)=tis	person
*peisistrati/dhs	group
*pu/qermos	person
*)androme/nhs	person
*)/aracos	place
*qrasu/loxos	person
*spoudi/as	person
*xalkidiko/s	ethnic
*(age/polis	person
*)/ader	person
*)/agdistis	place
*)/araros	person
*)/asanos	person
*)/arimoi	ethnic
*)elafhbo/lion	month
*ai)aki/dhs	group
*dama/retos	person
*)elafhbo/lion	month
*)epi/gonos	group
*)iessai=os	person
*)issh/dones	group
*ai)aki/dhs	group
*ai)guptiako/s	place
*ai)twliko/s	ethnic
*au)/gh	person
*bla/tios	person
*eu)fi/lhtos	person
*fqiw=tis	place
*fruni/wn	person
*fulli/das	person
*gadali/as	person
*dh=mos	person
*gedew/n	person
*masi/sths	person
*murleano\s	person
*peisistrati/dhs	group
*qermai=os	place
*)/adados	person
*lhoui/ths	group
*gorgo/nes	group
*dai/dala	place
*qesprwto/s	ethnic
*qrasu/loxos	person
*qrinaki/h	place
*samarei/ths	ethnic
*sanaballe/ths	person
*si/ttios	person
*skuqo/polis	place
*spa/rthqen	place
*trh/ras	ethnic
*tundari/dhs	group
*xaire/stratos	person
*xalkidiko/s	place
*pe/rshs	ethnic
*lampitw/	person
*)alkisqe/nhs	person
*)/alkwn	person
*)ago/ratos	person
*xoro/s	group
*)ame/nwfis	person
*)elissai=os	person
*au)so/nios	place
*bw=lis	person
*damasi/as	person
*di/nwn	person
*eu)fah/s	person
*korufa/sion	place
*la/banos	person
*madihni/ths	ethnic
*nw=xos	person
*petrh/ios	person
*puqw/n	place
*se/cstos	person
*se/cstios	person
*seilhno/s	group
*talao/s	person
*tri/twn	group
*(ellanodi/kai	group
*(ieremi/as	person
*ei)/ra	place
*fame/as	person
*filokth/mwn	person
*fou/louios	person
*la/zaros	person
*mardoxai=os	person
*mega/bazos	person
*sa/dwkos	person
*sou/sios	ethnic
*(/upanis	place
*)=wpis	place
*)/arbhla	place
*)ezeki/as	person
*)ioudai+ko/s	ethnic
*)issiko/s	ethnic
*)iw/asos	person
*)iwa/keimos	person
*brettaniko/s	place
*(ieremi/as	person
*luki=nos	person
*la/kwn	ethnic
*fai/ac	ethnic
*medou/sa	person
*ba/kxh	group
*li/gus	ethnic
*)italo/s	ethnic
*pieri/des	group
*li/banos	place
*)artafre/nhs	person
*)argo/qen	place
*)atrei/dhs	group
*fuloma/xh	person
*koru/bas	group
*ba/kxios	person
*leo/ntixos	person
*penqesilei/a	person
*sata/n	person
*trifuli/h	place
*)/altis	place
*leui/ths	group
*ligustiko/s	place
*dwriko/s	ethnic
*ti=tos	person
*)iliako/s	ethnic
*strou=ktos	person
*su/rtis	place
*tauriko/s	place
*)orne/ai	place
*go/rgwn	group
*sa/turos	group
*nu/mfai	group
*sisu/ggambris	person
*dwrieu/s	ethnic
*kai/swn	person
*ai)gestai=os	ethnic
*phlousiako/s	place
*posto/mios	person
*genou/kios	person
*ki/lic	ethnic
*ai)kolano/s	ethnic
*)abdhri/ths	ethnic
*)ambrakiw/ths	ethnic
*(hraklew/ths	ethnic
*za/gklh	place
*solpi/kios	person
*minu/ai	place
*koi/+nktios	person
*bou=ra	place
*lokrh/tios	person
*gega/nios	person
*tri/kostos	person
*nau/tios	person
*kw=|os	ethnic
*kou/rhtes	group
*ai)nia/n	ethnic
*ai)qa/leia	place
*)imi/lkwn	person
*(hraklei/dhs	group
*molosso/s	ethnic
*kube/lh	person
*qi/brwn	person
*)imi/lkas	person
*sikano/s 	ethnic
*)amazoni/s	group
*danao/s	ethnic
*)amazw/n	ethnic
*sikelo/s	ethnic
*kalano/s	person
*makedo/nios ethnic
*makedoniko/s	ethnic
*qai/s	person
*)alecandristh/s	person
*ca/nqhs	person
*(/abrwn	person
*(/arpuia	person
*(/hraion	person
*(/ippwnac	person
*(/irtios	person
*(/istros	person
*(/orta	person
*(/rutinon	person
*(agnou/sios	person
*(alai=os	person
*(alikarnaseu/s	person
*(armo/nios	person
*(eca/pula	person
*(ekath/sion	person
*(ekatombaiw/n	month
*(eli/kwna	person
*(elladiko/s	person
*(ellh/nios	person
*(epta/xalkon	person
*(ere/nnios	person
*(erma/noubis	person
*(ermai=os	person
*(ermi/nios	person
*(ermo/dotos	person
*(estia/des	group
*(estia/des	person
*(estiai/a	person
*(hgh/sippos	person
*(hlio/ph	person
*(hliopoli/ths	person
*(hrai=os	person
*(hraklei/teios	person
*(hraklei/dai	ethnic
*(hraklew/ths	person
*(hrofi/lh	person
*(hrw/ndas	person
*(hsio/deios	person
*(idrieu/s	ethnic
*(idrieu/s	person
*(ieroso/lumos	person
*(ippoda/meia	person
*(ippoko/wn	person
*(ippokownti/dai	ethnic
*(ippolu/th	person
*(omhriko/s	person
*(omolo/i+xos	person
*(ora/tios	person
*(orth/sios	person
*(osti/lios	person
*(ramno/eis	person
*(re/mos	person
*(rh=glos	person
*(rhnei/a	person
*(rhta=na	person
*(rodiako/s	ethnic
*(roisa/khs	person
*(rou/brios	person
*(roubi/kwn	person
*(roumi=na	person
*(roumina=lis	person
*(routi/lios	person
*(rw/skios	person
*(rwmaisti/	person
*(ua/nteia	person
*(uaki/nqia	person
*(uampei/a	person
*(upe/rh	person
*(urw/dhs	person
*(uyai=os	person
*(uyi/wn	person
*(uyikre/wn	person
*(uyipu/lh	person
*(wra/tios	person
*(wrati/a	person
*(wroma/zhs	person
*)/adrhstos	person
*)/agraulos	person
*)/akka	person
*)/amhstris	person
*)/anakes	ethnic
*)/anakes	person
*)/androklos	person
*)/antrwn	person
*)/antwn	person
*)/apopis	person
*)/aquri	person
*)/arbhlos	person
*)/aresan	person
*)/areus	person
*)/arkesos	person
*)/arrous	person
*)/arrwn	person
*)/arsalos	person
*)/arshlis	person
*)/asias	person
*)/askalis	person
*)/askalis	place
*)/assios	person
*)/atropos	person
*)/attios	person
*)/efura	person
*)/ekdhlos	person
*)/empedos	person
*)/epona	person
*)/eratos	person
*)/ersa	person
*)/ifiklos	person
*)/indarnos	person
*)/indios	person
*)/ogxhstos	person
*)/oloros	person
*)/omfis	person
*)/oppios	person
*)/oxnh	place
*)/wrikos	place
*)=ilos	person
*)abdalw/numos	person
*)abdhri/ths	person
*)abenti=nos	person
*)abenti=nos	place
*)aci/oxos	person
*)acio/s	person
*)adriatiko/s	person
*)adw/nia	person
*)afra/nios	person
*)afrodi/sios	person
*)aglaoni/kh	person
*)agorai=os	person
*)agria/n	person
*)agxa/rios	person
*)akadhmai+ko/s	group
*)akadhmai+ko/s	person
*)akadhmiako/s	group
*)akadhmiako/s	person
*)aki/dousa	person
*)aki/lios	person
*)aku/lios	person
*)aku/llios	ethnic
*)aku/llios	person
*)alala/	person
*)albani/s	ethnic
*)albi/nios	person
*)alecandro/polis	person
*)alecandrw/dhs	person
*)aleu/hs	person
*)alfeo/s	person
*)alia/s	person
*)alkaqo/h	person
*)/alkaqos	person
*)alkme/wn	person
*)alli/a	person
*)alli/as	person
*)allo/bric	ethnic
*)alw/pekos	place
*)amalqei/a	person
*)amaqou/sios	person
*)amazoniko/s	person
*)ambrakiw/ths	person
*)ame/nqhs	person
*)ameloi=	place
*)amfa/rhs	person
*)amfi/qeos	person
*)amfiktu/wn	person
*)amfiktuoni/a	group
*)amfiktuoniko/s	person
*)amfiqe/h	person
*)ammou=s	person
*)amnai=os	person
*)amoibeu/s	person
*)amou/lios	person
*)ana/bous	person
*)anaci/leus	person
*)anaci/lhs	person
*)anacw/	person
*)andro/kottos	person
*)ani/kios	person
*)ani/pph	person
*)anqemi/wn	person
*)anqemo/kritos	person
*)anqesthriw/n	festival
*)anqesthriw/n	person
*)anqhdoni/a	place
*)ante/as	person
*)anti/a	person
*)antiath/s	person
*)antife/ra	person
*)antifw/n	person
*)antigoni/s	person
*)antigoniko/s	person
*)antimaxei/a	person
*)antisqe/neios	person
*)antu/llios	person
*)apatou/ria	person
*)api/h	place
*)apollwnia/tas	ethnic
*)apoulh/ios	person
*)apri/llios	month
*)ara/teion	person
*)araxw/sios	ethnic
*)araxw/sios	person
*)arbhli=tis	person
*)ardea/ths	ethnic
*)areima/nios	person
*)areopagi/ths	group
*)areopagi/ths	person
*)areopagitiko/s	person
*)argo/s	person
*)argoli/s	ethnic
*)argoli/s	person
*)argoliko/s	person
*)argonau/ths	person
*)argw/	person
*)ari/stratos	person
*)ariame/nhs	person
*)aridai=os	person
*)ario/bistos	person
*)aristi=nos	person
*)aristofa/neios	person
*)aristoni/kh	person
*)aristoteliko/s	person
*)arkadi/wn	person
*)arktou=ros	person
*)armeniako/s	person
*)arou/hris	person
*)arou/ntios	person
*)arrhfo/roi	person
*)arrou/ntios	person
*)artage/rshs	person
*)artau/+kths	person
*)artoce/rchs	person
*)arxe/moros	person
*)arxe/ptolis	person
*)arxepto/lemos	person
*)asi/nios	person
*)asi/nnios	person
*)aska/lafos	person
*)asklhpiei=on	person
*)askrai=os	ethnic
*)assa/kana	person
*)asta/rth	person
*)asw/	person
*)asw/pixos	person
*)ate/as	person
*)ath/ios	person
*)ati/lios	person
*)ati/llios	person
*)atlanti/s	person
*)atlantiko/s	person
*)atlantiko/s	place
*)atti/as	person
*)axaii/s	ethnic
*)axaio/s	ethnic
*)axaiiko/s	person
*)axradinh/	person
*)axradinh/	place
*)ayefi/wn	person
*)egeri/a	person
*)elafhbo/lia	festival
*)elafhbo/lia	person
*)elatei/a	person
*)elatei/a	place
*)elbi/a	person
*)elefanti/nh	place
*)eleuqerai/	person
*)eleuqerai/	place
*)eleusino/qen	place
*)elieu/s	ethnic
*)elimi/ai	person
*)ello/pios	person
*)empedo/kleios	person
*)enueu/s	person
*)epida/mnios	ethnic
*)epikou/reios	group
*)epimhqeu/s	person
*)epita/kths	person
*)epitala/rios	person
*)epixa/rmeios	person
*)epizefu/rios	person
*)era/twn	person
*)ere/xqeion	person
*)eretrieu/s	ethnic
*)eretrieu/s	person
*)eretriko/s	person
*)erexqhi/s	person
*)ergi/aios	person
*)ergote/lhs	person
*)eria/nqhs	person
*)eru/cis	person
*)eru/kinos	person
*)erucw/	person
*)erxieu/s	person
*)exi=nai	person
*)hetiw/neia	person
*)hlu/sion	person
*)hlu/sion	place
*)ia/dmwn	person
*)ia/dwn	person
*)ia/s	person
*)iakxei=on	person
*)ialuso/s	person
*)iano/s	person
*)ianoua/rios	month
*)ianoua/rios	person
*)iao/nios	person
*)iaseu/s	person
*)ibhriko/s	ethnic
*)ibhriko/s	person
*)ih/ios	person
*)inaxieu/s	person
*)io/bhs	person
*)io/leus	person
*)ioba/ths	person
*)iogo/rqas	person
*)iou/nios	person
*)iouli/a	person
*)isa/ras	person
*)isauriko/s	person
*)isei=on	person
*)isi/as	person
*)isiako/s	person
*)ismhno/s	person
*)ismhnodw/ra	person
*)isodi/kh	person
*)isqmia/s	person
*)/isqmia	festival
*)issw/rios	person
*)italiko/s	ethnic
*)itw/nios	person
*)itwni/s	person
*)iwni/s	person
*)oa/rshs	person
*)ocu/aqros	person
*)okrhsi/a	person
*)okridi/wn	person
*)oktaou/i+os	person
*)olei=ai	person
*)olu/mpixos	person
*)olumpi/eion	person
*)olumpiako/s	person
*)olumpiako/s	place
*)olumpioni/kh	person
*)ombri/kios	person
*)ono/skelis	person
*)opi/mios	person
*)ore/steios	person
*)oro/bazos	person
*)oroa/ndhs	person
*)orqi/a	person
*)osirei=os	person
*)osiriako/s	person
*)osta/nhs	person
*)otaki/lios	person
*)ozo/lai	place
*)rari/a	person
*)wgu/gios	person
*)widei=on	person
*)wri/wn	person
*ai(/mwn	person
*ai)/geiroi	place
*ai)/gesta	person
*ai)/gwn	person
*ai)/nios	person
*ai)/nitos	person
*ai)/qh	person
*ai)/qic	person
*ai)/sxrh	person
*ai)=klos	person
*ai)anti/s	group
*ai)anti/s	person
*ai)cwneu/s	person
*ai)dhyo/s	person
*ai)ghi/s	person
*ai)guptiako/s	person
*ai)guptisti/	person
*ai)li/wn	person
*ai)mili/a	person
*ai)nia/n	person
*ai)o/lios	person
*ai)qaki/a	person
*ai)sku/liai	person
*ai)sw/peios	person
*ai)twli/s	person
*ai)twliko/s	person
*au)/gour	group
*au)/goustos	person
*au)/sic	person
*au)fi/dios	person
*au)ge/as	person
*au)rh/lios	person
*au)to/boulos	person
*ba/kxh	person
*ba/kxwn	person
*ba/ndios	person
*ba/nwn	person
*ba/rrwn	person
*ba/sillos	person
*bai/bios	person
*baleariko/s	person
*baqu/llios	person
*baste/rnhs	ethnic
*bath=qen	person
*bati/nios	person
*be/bwn	person
*be/sbion	person
*be/ssos	person
*bellerofo/nths	person
*bergeli/wn	person
*beroi/a	person
*beroni/kh	person
*betou/tios	person
*bhpolitano/s	person
*bhsti/as	person
*bi/lippos	person
*bisa/lths	person
*ble/yos	person
*blo/ssios	person
*bohdro/mia	person
*bohdromiw/n	month
*boiw/tios	ethnic
*boiw/tios	person
*boiwtiako/s	person
*bokw/nios	person
*bolou/mnios	person
*borusqeni/ths	person
*botti/aios	person
*bou/lis	person
*bou=tos	person
*bouka/tios	person
*boukefali/a	person
*boulai=os	person
*braurw/n	person
*braurwno/qen	place
*braxu/llhs	person
*bre/nnos	person
*brettano/s	person
*bri/ghs	person
*brishi/+s	person
*bulli/s	person
*ceinago/ras	person
*cenai/netos	person
*cenokri/ths	person
*da/ndamis	person
*da/oxos	person
*da/tis	person
*dai/sios	person
*dama/trios	person
*damash/nwr	person
*dami/ndas	person
*damo/fantos	person
*damokri/ta	person
*dasku/lhs	person
*daskuli=tis	person
*de/kimos	person
*de/kios	person
*de/llios	person
*de/rkullos	person
*deci/qeos	person
*decikre/wn	person
*deciqe/h	person
*dei/dios	person
*dei=mos	person
*deiradiw/ths	person
*deke/mbrios	ethnic
*deke/mbrios	month
*dhidamei/a	person
*dhio/khs	person
*dhma/retos	person
*dhma/rhtos	person
*dhmh/treioi	person
*dhmhtriw/n	person
*dhmo/dikos	person
*dhmodi/kh	person
*dhmokri/teioi	person
*dhmu/los	person
*dhmw/	person
*dhmw/nac	person
*dhnai/h	person
*di/ktunna	person
*dia/krioi	person
*dia/sia	person
*dia=lis	person
*diadhma/tas	person
*didumai=os	person
*dikaia/rxeia	person
*dio/mnhstos	person
*dioge/neion	person
*diogei/twn	person
*diogeniano/s	person
*dionusiako/s	person
*diopei/qhs	person
*dioxi/th	person
*diw/ndas	person
*dome/tios	person
*dometiano/s	person
*douli/xios	person
*dru/os	person
*du/sparis	person
*dw/tion	person
*dwdwni/s	person
*dwriko/s	person
*ei)lio/neia	person
*eu)/ios	person
*eu)/mhtis	person
*eu)/qippos	person
*eu)/strofos	person
*eu)/tuxos	person
*eu)=ktos	person
*eu)boiko/s	person
*eu)fro/nios	person
*eu)h/meros	person
*eu)menh/s	person
*eu)molpi/dai	ethnic
*eu)molpi/dai	person
*eu)no/sta	person
*eu)qume/nhs	person
*eu)ru/anassa	person
*eu)rupw/n	person
*eu)te/rph	person
*eu)wnumeu/s	person
*fa/lion	person
*fa/nnios	person
*fa/sis	person
*fabo/la	person
*fabri/kios	person
*fai/nwn	person
*faistu/los	person
*faleri=nos	person
*falhroi=	person
*fallhfo/ria	person
*fanai=os	person
*farna/keia	person
*fau=stos	person
*faw/nios	person
*fawfi/	person
*febroua/rios	month
*febroua/rios	person
*feido/laos	person
*fene/stella	person
*ferenda/ths	person
*ferse/fassa	person
*fh/lic	person
*fi/kion	person
*fi/larxos	person
*fi/linna	person
*filai=os	person
*filh/s	person
*fili/ppeios	person
*fili/pph	person
*filippiko/s	person
*filo/kupros	person
*filo/logos	person
*filo/pappos	person
*filofa/nhs	person
*filomh/twr	person
*filoxa/ras	person
*filwti/s	person
*flamen	role
*flamini/ka	place
*flamini=nos	person
*flueu/s	person
*fo/rbas	person
*fo/rkos	person
*fonth/ios	person
*fou/rnios	person
*fqi=os	person
*fqiw/ths	person
*fraa/ths	person
*frea/rrios	group
*frea/rrios	person
*fru/gios	ethnic
*fru/gios	person
*fru/nwn	person
*fu/skios	person
*fu/skwn	person
*fula/kh	person
*fwkai/h	person
*fwkiko/s	ethnic
*fwkiko/s	person
*gadeirai=os	person
*gala/ths	person
*galaci/dwros	person
*galatiko/s	ethnic
*galatiko/s	person
*gamhliw/n	person
*gandri/dai	ethnic
*garai/tion	person
*ge/llios	person
*ge/nqios	person
*ge/skwn	person
*gedrw/sioi	person
*gefurai=os	person
*gegani/a	person
*gelw=|os	person
*gemi/nios	person
*gene/twr	person
*genei/ta	person
*genu/kios	person
*gerada/tas	person
*geranei/a	place
*germanikh/	person
*germaniko/s	person
*ghruo/nhs	person
*gi/gas	person
*gi/gis	person
*gi/skwn	person
*gindi/ka	person
*glabri/wn	person
*gna/qwn	person
*gnaqai/nios	person
*go/rgeios	person
*gorpiai=os	person
*gra/gxos	person
*gra/nios	person
*grai+ko/s	ethnic
*graniko/s	place
*gru/llos	person
*gu/lwn	person
*gumnosofistai/	person
*gurtia/s	person
*ka/fis	person
*ka/llaisxros	person
*ka/mma	person
*ka/mwn	person
*ka/ntabroi	ethnic
*ka/nwbos	person
*ka/qhtos	person
*ka/rneia	person
*kabu/h	person
*kafe/nh	person
*kafisi/as	person
*kafu/h	person
*kai/lios	person
*kaidi/kios	person
*kaikili/a	person
*kaineu/s	person
*kaininh/ths	person
*kaipi/wn	person
*kaisari/wn	person
*kalau/ria	person
*kalauri/a	person
*kalbi/a	person
*kalligenei/a	person
*kaloui/sios	person
*kalpou/rnios	person
*kalpourni/as	person
*kampano/s	person
*kanqari/wn	person
*kapetw/lios	person
*kapetwli=nos	person
*kapitwli=nos	place
*kapra/rios	person
*karbi/lios	person
*kardiano/s	ethnic
*kardiano/s	person
*karme/nth	person
*karmenti/s	person
*kassiopai/a	person
*kau/dinos	person
*ke/ler	person
*ke/ntauros	group
*ke/ntauros	person
*ke/qhgos	person
*ke/rkafos	person
*kegxre/h	person
*keki/lios	person
*keki/nas	person
*kelai/nhs	person
*keleo/s	person
*keltosku/qai	person
*kenswri=nos	person
*kerau/nios	person
*kerukurai=os	ethnic
*kerukurai=os	person
*ki/mbros	ethnic
*ki/mbros	person
*ki/rkaios	person
*ki/rkaios	place
*kiggw/nios	person
*kimbrikh/	person
*kimbriko/s	ethnic
*kiqairw/nios	ethnic
*kitih/s	person
*kle/obis	person
*kleo/dwros	person
*kleo/timos	person
*kleoni/kh	person
*kloi/lios	person
*kloili/as	person
*klou/bios	person
*klousi/a	person
*klutomh/dhs	person
*klwqw/	person
*knh/f	person
*knw/ssios	ethnic
*ko/klios	person
*ko/qos	person
*ko/rsika	place
*ko/ssos	person
*koi+/ntios	person
*koi/lios	person
*koi/ranos	person
*kokkh/ios	person
*kolluteu/s	person
*kolluto/s	person
*kolwno/s	person
*kolwno/s	place
*komi/nios	person
*kommi/nios	person
*konsi/dios	person
*kopti/ths	person
*kora/tios	person
*korduli/wn	person
*korh/tas	person
*koriolano/s	person
*korni/klana	place
*kornifi/kios	person
*koru/bas	person
*korunh/ths	person
*koskw/nios	person
*kossi/nios	person
*kou/rtios	person
*koui+nti/wn	person
*kouri/wn	person
*kra/neios	person
*kra/twn	person
*krassi/nios	person
*krassiano/s	person
*krathsi/kleia	person
*krau=gis	person
*kresfo/nths	person
*krhti/nhs	person
*krhtiko/n	ethnic
*krhtiko/n	person
*kri/mhsos	person
*kri/sos	person
*krispi=nos	person
*krito/la	person
*kronia/s	person
*kru/assa	place
*ku/dnos	person
*ku/rbas	person
*ku/xreus	person
*kudi/pph	person
*kuh/tos	person
*kuintili/as	person
*kula/rabis	person
*kulwnei=os	person
*kune/geiros	person
*kuno/sarges	person
*kunosoureu/s	person
*kuproge/neia	person
*kuprogenh/s	person
*kurhnaiko/s	person
*kuri=nos	person
*kuri=tis	person
*kuyeli/dai	person
*kwlw/ths	person
*kwlwta/rios	person
*kwmi/as	person
*la/arxos	person
*la/ggwn	person
*la/kaina	ethnic
*la/kaina	person
*la/mpis	person
*la/rkios	person
*la/xesis	person
*labew/n	person
*labi/nion	person
*lai/margos	person
*lakhth/r	person
*laki/adai	person
*lakwnismo/s	person
*lakwnisth/s	person
*lamiako/s	person
*lampri/as	person
*lamptreu/s	person
*lamya/kh	person
*laodikeu/s	person
*larenti/a	person
*laurenti=nos	person
*laxa/ras	person
*le/ntoulos	person
*le/ptos	place
*le/rna	person
*lebadei/a	place
*lebea/dos	person
*lekto/s	person
*leo/nnatos	person
*leonti/s	person
*lesxhno/rios	person
*leu/koullos	person
*leu=kos	person
*leu=ktros	person
*leui/ths	person
*leuka/tas	person
*leukani/s	person
*leukonoeu/s	person
*leukoqe/a	person
*leuktriko/s	person
*leukw/nios	person
*lewpre/phs	person
*lh/lanton	person
*lhnaiko/s	person
*li/gus	person
*libi/as	person
*libiti/nh	person
*liga/rios	person
*ligusti=nos	person
*liki/nios	person
*liki/nnios	person
*likinni/as	person
*likni/ths	person
*lo/xagos	person
*lou/kios	person
*lou=kar	person
*louki=na	person
*loukou/llos	person
*loukou/mwn	person
*loukrh/tios	person
*loukrhti/h	person
*louperka/lia	festival
*louta/tios	person
*lu/dios	ethnic
*lu/dios	person
*lu/kaia	person
*lu/kaion	person
*lu/sis	person
*luko/rmhs	person
*lukopoli/ths	ethnic
*lukou/rgeios	person
*lusandri/s	person
*lusi/qeos	person
*lusi/stratos	person
*lusita/neia	place
*ma/ios	person
*ma/kuna	person
*ma/lkandros	person
*ma/ndrwn	person
*ma/nhs	person
*ma/rsh	person
*ma/rsos	person
*ma/rtios	ethnic
*ma/rtios	person
*ma/rullos	person
*ma/ssuloi	person
*ma/swn	person
*ma=gnos	person
*magki=nos	person
*mai/lios	person
*maimakthriw/n	person
*mane/qwn	person
*manerw/s	person
*mani/lios	person
*maraka/ndana	person
*marfada/ths	person
*marike/as	person
*markelli=nos	person
*masaisu/lios	ethnic
*masana/sshs	person
*masi/stios	person
*matou=ta	person
*maxai/tas	person
*maxairi/wn	person
*me/lwn	person
*me/mmios	person
*me/naixmos	person
*me/ndai=os	person
*medoulli/na	person
*mega/buzos	person
*megalofa/nhs	person
*megalopoli=tis	person
*megalopolitiko/s	person
*megaro/qen	place
*megaroi=	person
*megisto/nous	person
*mei=nis	person
*mela/nths	person
*melanqei/a	person
*melhsi/as	person
*melhsippi/s	person
*melpome/nh	person
*mene/fulos	person
*mene/sqhs	person
*menh/nios	person
*mequ/er	person
*messa/pios	person
*metagei/tnia	person
*metageitniw/n	person
*metanei/ra	person
*meti/lios	person
*meze/ntios	person
*mi/kka	person
*mi/tus	person
*milhsiako/s	ethnnic
*minou/kios	person
*minu/kios	person
*miqridatiko/s	person
*mnasigei/twn	person
*mneu=is	person
*mnh/strh	person
*mnhsare/thn	person
*mnhsino/h	person
*mo/los	person
*mo/lpos	person
*molossi/s	person
*molu/kreia	person
*mou/kios	person
*mou/seios	person
*mouki/as	person
*moukiano/s	person
*mouna/tios	person
*mounixi/h	person
*mounixiw/n	person
*mounuxiw/n	person
*mouqi/as	person
*mourki/a	person
*mousei=on	person
*moushge/ths	person
*mouskw=sa	person
*mousw/nios	person
*mu/ndios	person
*murrinou/sios	person
*mursi/los	person
*murta/lh	person
*murti/h	person
*na/cios	ethnic
*na/cios	ethnnic
*na/cios	person
*name/rths	person
*ne/fqus	person
*neapo/litos	person
*neile/ws	person
*neilw=|os	person
*nekta/nabis	person
*nemanou=s	person
*neo/xwros	person
*neobou/lh	person
*nerwniano/s	person
*nhrhi/s	group
*pelopi/dhs	group
*ko/mwn	person
*pasi/as	person
*)agora/sths	person
*)hlei=os	ethnic
*tritoge/neia	person
*)abennh=ros	person
*)abia/qaros	person
*)ioudaiko/s	ethnic
*)/oculos	person
*danai/dai	group
*filw/ndas	person
*gi/sxala	place
*naia/s	group
*ou)rani/wnes	group
*ni/sibis	person
*ni=sos	person
*nigi/dios	person
*nigri=nos	person
*nika/twr	person
*nikago/rh	person
*niki/wn	person
*niko/strath	person
*noma/s	ethnic
*noma/s	person
*nomi/twr	person
*noume/rios	person
*nu/ktimos	person
*nukte/lia	festival
*nukte/lia	person
*numfai=os	person
*numfi/dios	person
*nw/nios	person
*oi)/noklos	person
*oi)/noufis	person
*oi)/noy	person
*oi)dipo/deios	person
*ou)a/rios	person
*ou)a=ros	person
*ou)alle/ri	person
*ou)ati/nios	person
*ou)e/ntwn	person
*ou)e/ttios	person
*ou)ergi/nios	person
*ou)etou/rios	person
*ou)i/bios	person
*ou)i/nios	person
*ou)indi/kios	person
*pa/gxwn	person
*pa/koros	person
*pa/naima	person
*pa/nakton	place
*pa/nemos	person
*pa/nqeia	person
*pagxw=os	person
*paiw/nios1	person
*pakkiano/s	person
*pala/tion	person
*palai/skhyis	person
*palla/ntios	person
*palw=des	place
*pamboiw/tia	person
*pamu/lhs	person
*pamu/lia	festival
*panaqh/naia	festival
*panaqhnaiko/s	person
*pane/llhnes	ethnic
*panteu/s	person
*papei/rios	person
*papi/rios	person
*papiri/a	person
*paraou/hs	person
*parmeni/deios	person
*parqenw/n	person
*parqiko/s	ethnic
*parqiko/s	person
*pase/as	person
*pataiki/wn	person
*patro/bios	person
*patrwni/s	person
*pedieu/s	person
*peiqo/laos	person
*peisi/as	person
*peisiana/kteios	person
*peligno/s	ethnic
*pellhnai=os	ethnic
*peloponnhsiako/s	ethnic
*peloponnhsiako/s	person
*peripathtiko/s	group
*perraibi/a	place
*perraibo/s	person
*persefo/neia	person
*peti/llios	person
*peuke/sths	person
*phlia/s	person
*pi/gras	person
*pi/naros	person
*pi/sidos	person
*pieri/wn	person
*pikhni/s	person
*pina/rios	ethnic
*pina/rios	person
*piqoi/gia	festival
*piraeu/s	ethnic
*pisai=os	place
*pissou/qnhs	person
*pitta/keios	person
*pituoesshno/s	ethnic
*plaqa/nh	person
*plataia=si	place
*plataiiko/s	person
*platwniko/s	person
*pleia/s	star
*plhmmu/rion	place
*plw/tios	person
*po/dargos	person
*po/ltus	person
*po/ntis	person
*po/rkios	person
*po/stoumos	person
*podh=s	person
*poimandri/a	person
*polli/wn	person
*polu/kriqos	person
*polu/mnia	person
*polu/mnis	person
*polu/stratos	person
*polukri/ths	person
*polupe/rxwn	person
*pompai/dios	person
*pomphi/a	person
*pompi/lios	person
*pompw/nios	person
*ponhro/polis	person
*pontiko/s	person
*popi/lios	person
*popi/llios	person
*poppai/a	person
*porki/as	person
*porsi/nas	person
*postou/mios	person
*potidai/a	person
*pou/plios	person
*pouluti/wn	person
*pri/mas	person
*pri/nistos	person
*primige/neia	person
*profqasi/a	person
*promaqei/a	person
*prome/dwn	person
*pronai/h	person
*prose/lhnos	person
*pu/qhs	person
*pu/randros	person
*puaneyiw/n	person
*pudnai=os	person
*pulao/xos	person
*puqa/ratos	person
*puqiko/s	person
*puqioni/kh	person
*puqoni/kh	person
*puqopoli/ths	person
*puqw/de	person
*puqwno/qen	person
*purso/fion	person
*qa/leia	person
*qa/lhs	person
*qa/llos	person
*qamou=s	person
*qamu/ras	person
*qargh/lia	festival
*skerdilai/+das	person
*qarghliw/n	person
*qe/rsippos	person
*qe/sth	person
*qe/wlos	person
*qe/wros	person
*qea/nwr	person
*qemiste/as	person
*qespe/sios	person
*qesprwto/s	person
*qew/rios	person
*qh/bhsin	person
*qh/bhsin	place
*qhrasi/a	person
*qhri/kleios	person
*qhruki/wn	person
*qhsei/dai	person
*qhshi/s	person
*qi/mbrwn	person
*qou/hris	person
*qou/rios	person
*qra/keus	person
*qra/kios	ethnic
*qra/kios	person
*qra/swn	person
*qra=|ssa	ethnic
*qra=|ssa	person
*qrase/as	person
*qra|kiko/s	person
*qria/sios	person
*qu/bris	person
*quia/s	person
*qumote/lhs	person
*qurea/tis	person
*qwruki/wn	person
*sa/gktos	person
*sa/is	person
*sa/lbios	person
*sa/lios	person
*sa/louios	person
*sa/mbikos	person
*sa/ndanos	person
*sa/ndwn	person
*sa/rapis	person
*sa/rmentos	person
*sali/a	person
*salmatiko/s	person
*salou/stios	person
*salw/nios	person
*samni/ths	ethnic
*samoqra/|kh	place
*samoqra/|kion	ethnic
*sapfiko/s	person
*sarapi/wn	person
*sardana/pallos	person
*satilai=os	person
*satorni=nos	person
*sauni/ths	person
*se/ctios	person
*se/ntios	person
*se/rbios	person
*se/rouios	person
*sebennu/th	person
*secti/lios	month
*secti/lios	person
*sei/rios	person
*sei/rwn	person
*seira/mnhs	person
*seirh/n	group
*posidh/ios	person
*)/isakos	person
*)abime/lexos	person
*)ambrakiko/s	place
*)amfiloxiko/s	place
*)/asteios	person
*)eruqei/a	place
*)exi=nai	place
*)isma/hlos	person
*)italo/s	ethnic
*)wrei/quia	person
*ba/ktrios	ethnic
*ei)/rwmos	person
*eu)/ergos	person
*eu)fh/mios	person
*garsu/hris	person
*gobru/hs	person
*kerau/nia	place
*knw/sios	place
*kwkuto/s	place
*lew/stratos	person
*na/bwqos	person
*pa/tala	place
*pitta/lakos	person
*prhca/sphs	person
*priami/dhs	group
*saddoukai=oi	group
*saxxi/as	person
*ti/fus	person
*)alkmewni/dhs	group
*xa/luy	group
*zoroba/bhlos	person
*kleiw/	person
*li/ghr	ethnic
*mardoxai=os	person
*pontiko/s	ethnic
*(robo/amos	person
*semira/mis	person
*semprw/nios	person
*sene/kas	person
*seneki/wn	person
*septe/mbrios	person
*septh/rios	person
*septi/mios	person
*septomou/ntion	person
*serapei=on	person
*serbi/lios	person
*serbwni/s	person
*serrano/s	person
*sfh/ttios	person
*sfhttoi=	person
*sh/ios	person
*sh/q	person
*si/gnifer	person
*si/kinnon	person
*si/kinnos	person
*si/llos	person
*si/lwn	person
*sibu/lleios	person
*sikeliw=tis	person
*siki/nnios	person
*siloua=nos	person
*simu/los	person
*sina/tos	person
*sino/ric	person
*sisimi/qrhs	person
*skaio/las	person
*ske/dasos	person
*skei/rwn	person
*ski/louros	person
*skia/s	person
*skilou=ros	person
*skira/dion	person
*skirroforiw/n	person
*sko/padai	person
*sko/tios	person
*skotousai=os	person
*skumbra/ths	person
*skuqiko/s	ethnic
*smi/kuqos	person
*so/filos	person
*so/gxitos	person
*so/os	person
*sofo/kleios	person
*sou/perbos	person
*sou/rhs	person
*spa/rtakos	person
*sparta/keios	group
*sparta/keios	person
*sparti/atis	ethnic
*sparto/s	person
*spe/rxis	person
*spo/rios	person
*stageiri/ths	ethnic
*stati/lios	person
*ste/fon	person
*sterti/nios	person
*sthsi/xoros	person
*sti/lbwn	person
*sto/lwn	person
*stroi=bos	person
*strou/qios	person
*stwiko/s	group
*su/baris	person
*su/baris	place
*su/rtis	person
*subari/ths	ethnic
*subari/ths	person
*subaritiko/s	person
*subou/rh	person
*suhni/ths	person
*suriako/s	person
*suristi/	person
*sw/klaro/s	person
*sw=qis	person
*sw=spis	person
*swklh/s	person
*swkratiko/s	person
*swrna/tios	person
*swte/lhs	person
*ta/nais	place
*ta/tios	person
*ta/xws	person
*tala/sios	person
*tanakulli/s	person
*tanitiko/s	person
*tanta/leios	person
*tarph/ios	person
*tarphi/a	person
*tarrou/tios	person
*tau/geton	person
*taure/as	person
*te/llhs	person
*te/llos	person
*te/mwn	person
*te/nhs	person
*te/rminos	person
*te/ttic	person
*te/xnaktis	person
*te/xnwn	person
*tele/sths	person
*telesi/ppas	person
*telesi=nos	person
*telhti/as	person
*tellh/n	person
*tere/ntios	person
*terenti/a	person
*terme/reion	person
*termina/lia	festival
*terti/a	person
*th/ras	person
*thri/bazos	person
*ti/llios	person
*ti/mandra	person
*ti/tios	person
*tibou=ris	person
*tigelli=nos	person
*timoce/na	person
*timoleo/nteion	person
*timoqe/a	person
*tiri/bazos	person
*tisafe/rnhs	person
*tisi/as	person
*titaniko/s	person
*titi/nios	person
*titiano/s	person
*to/lmaios	person
*torkoua=tos	person
*tosiwpw=n	person
*tou/cion	person
*tou=skos	person
*toube/rwn	person
*tourpiliano/s	person
*touski=nos	person
*tousklanari/h	person
*trai+ano/s	person
*treba/tios	person
*trebe/llios	person
*trebw/nios	person
*trh/ras	person
*tri/fullos	person
*tria/rios	person
*trio/pion	person
*tripodi/skios	person
*trw/skios	person
*trwa/s	ethnic
*trwi/+los	person
*tu/lifos	person
*tu/llios	person
*tu/nnixos	person
*tufw/s	person
*tufw=n	person
*tufwnei=os	person
*tufwniko/s	person
*tunda/reios	person
*tunda/rhs	person
*turrhni/s	ethnic
*turrhni/s	person
*xa/rillos	person
*xa/rmios	person
*xa/rmos	person
*xa/wn	person
*xairw/ndas	person
*xalkhdoni/ai	ethnic
*xalkioph/	person
*xalubw/nios	person
*xari/leus	person
*xari/lhs	person
*xari=nos	person
*xariklh/s	person
*xarwni=tai	person
*xeiroma/xa	person
*xersi/as	person
*xersonhsi/ths	ethnic
*xersonhsi/ths	person
*xhmi/a	person
*xi/lwn	person
*xi/marros	person
*xli/dwn	person
*xo/noufis	person
*xolargeu/s	person
*xro/mios	person
*xrushi/s	person
*xrusi/s	person
*ya/mmwn	person
*yama/qh	person
*yammh/tixos	person
*yolo/hs	person
*yuttalei/a	person
*yuttalei/a	place
*zei/poitos	person
*zelei/ths	person
*zwi/los	person
*zwroa/strhs	person
-Mt.	person
Aelius	person
Aemilius	person
Ancus	person
Arava	person
Arrius	person
Aurelia	person
Bononia	person
Canidius	person
Carbo	person
Casca	person
Castus	person
Celsus	person
Charicles	person
Cinna	person
Clodia	person
Comitium	person
Consta	person
Consuelia	person
Curinalia	person
Demoteles	person
Fabia	person
Faestulus	person
Faunus	person
Fetiales	role
Flaminia	person
Flora	person
Fluvianus	person
Fufetius	person
Fundanus	person
Furnicalia	festival
Gestius	person
Helvia	person
Iulia	person
Licinia	person
Livius	person
Luperca	person
Macellus	person
Macer	person
Maecenas	person
Marcia	person
Metella	person
Mettius	person
Modestus	person
Nepos	person
Nonnius	person
Nuceria	person
Numa	person
Pansa	person
Paterculus	person
Phrynis	person
Pius	person
Pomponia	person
Priscus	person
Pulchra	person
Pupius	person
Quadrantarius	person
Regulus	person
Romanus	ethnic
Scaurus	person
Sejanus	person
Servilia	person
Silvia	person
Stator	person
Stellus	person
Tarquinius	person
Temenites	person
Tiro	person
Tullia	person
Tullus	person
Veii	person
Veneralia	person
Vergilius	person
Verres	person
Vibo	person
Vindex	person
Voconius	person
Volumnia	person
Volumnia	place
Volusci	ethnic
Xenares	person
*bria/rews	person
*di=nos	person
*)/erws	person
*qesmofo/ria	festival
*qesmofo/ria	person
*(/hra	group
*(/ubris	persName
*(adriano/s	persName
*(adriano/s	persName
*(amadrua/des	group
*(amadrua/des	group
*(amadrua/des	group
*(ermai=os	group
*(esperi/h	placeName
*(esperi/h	persName
*(esperi/ths	group
*(ierh/	persName
*(ippodro/mos	persName
*(omh/reios	persName
*(omh/reios	group
*(omh/reios	group
*(omh/reios	group
*(omh/reios	persName
*(omhroke/ntrwn	placeName
*(ua/des	group
*(ume/naios	persName
*(ume/naios	persName
*(ume/naios	persName
*(ume/naios	group
*(umh/n	group
*)/adwn	persName
*)/akratos	persName
*)/askrh	persName
*)/awos	persName
*)/orqos	group
*)adriako/s	persName
*)adriako/s	persName
*)adriano/s	group
*)agamemno/neos	persName
*)agamemno/neos	persName
*)agela/dhs	placeName
*)alh/ios	persName
*)alki/dhs	persName
*)alki/dhs	persName
*)amfia/rhos	persName
*)amfiklh=s	persName
*)ammwniako/s	group
*)antiklh=s	persName
*)anu/th	persName
*)argw=|os	persName
*)ari/bazos	placeName
*)ari/bazos	persName
*)ari/sths	persName
*)arista/rxeios	group
*)arxilo/xeios	persName
*)askw/ndhs	persName
*)astuana/kteios	persName
*)atqi/s	persName
*)atqi/s	persName
*)atqi/s	persName
*)atqi/s	placeName
*)atqi/s	group
*)atqi/s	persName
*)atqi/s	persName
*)axaimeni/dhs	persName
*)axaimeni/dhs	persName
*)axarni/ths	persName
*)axero/ntios	group
*)axerontia/s	placeName
*)axerou/sios	group
*)axerousi/s	placeName
*)elei/quia	persName
*)elei/quia	persName
*)eleuqe/rios	persName
*)ennosi/gaios	persName
*)ennosi/gaios	group
*)enosi/xqwn	persName
*)era/sippos	persName
*)erexqei=dai	group
*)eruma/nqios	persName
*)erwta/rion	persName
*)heti/dhs	persName
*)hpio/nh	persName
*)iapetioni/dhs	persName
*)ika/rios	persName
*)ilia/dai	placeName
*)ilisso/s	placeName
*)indole/ths	persName
*)inwpo/s	persName
*)io/bakxos	persName
*)itali/dhs	group
*)itwnia/s	persName
*)odrusi/s	persName
*)odu/sseios	persName
*)oppia/n	persName
*)oqrua/dhs	placeName
*)oqrua/dhs	persName
*)oqrua/dhs	persName
*)oqrua/dhs	persName
*)wle/nios	persName
*ai)a/nteios	persName
*ai)gei/dhs	group
*ai)gialeu/s	group
*au)soni/s	persName
*au)tome/linna	persName
*bakxeu/s	persName
*bakxia/dai	group
*bakxiako/s	group
*bakxiako/s	group
*beroiai=os	persName
*bistoni/s	group
*borrai=os	group
*borrai=os	persName
*boupa/leios	persName
*ce/nios	persName
*da=los	persName
*da=os	persName
*damo/nikos	persName
*dardani/dhs	persName
*dardani/dhs	persName
*dardani/dhs	group
*dardani/dhs	group
*dardani/s	persName
*delfi/nios	persName
*dhi/maxos	persName
*di/duma	placeName
*didu/mwn	persName
*diogenei/a	persName
*diogenh/s	group
*drua/s	group
*drua/s	persName
*eu)/kleios	group
*eu)fra/ntas	persName
*eu)fra/ntas	persName
*eu)qu/maxos	persName
*eu)rupu/lh	persName
*faihki/s	placeName
*fainare/th	persName
*falhriko/s	persName
*fi/ntwnos	persName
*filomh/lh	persName
*filomh/lh	persName
*foi/beios	placeName
*foi/beios	persName
*foi/beios	persName
*foibhi/s	placeName
*foibhi/s	persName
*fw/kios	persName
*fw/kritos	persName
*ge/mellos	persName
*giga/nteios	placeName
*gorgo/nion	persName
*ka/lxas	persName
*ka/stron	placeName
*kafhri/s	group
*kaisareu/s	persName
*kaisareu/s	group
*kalli/gnwtos	persName
*kalli/gnwtos	persName
*kalli/xoron	persName
*kamiko/s	persName
*karpw/	persName
*kekropi/dai	group
*kekropi/dai	group
*kekropi/dai	persName
*kekropi/dai	group
*kekropi/s	group
*kekropi/s	persName
*kekropi/s	group
*kekropi/s	persName
*khfisieu/s	persName
*kisshi/+s	persName
*klea/dhs	persName
*kleinare/th	persName
*kleitago/rh	persName
*kleo/laos	persName
*klew/	persName
*klew/	persName
*klh/swn	persName
*kra/nios	persName
*kreontia/dhs	placeName
*kri/spos	persName
*krio/s	persName
*kro/nios	group
*kroniko/s	group
*ku/belon	placeName
*kuni/skh	persName
*kuno/s	persName
*kunosou/ra	placeName
*kunqogenh/s	persName
*kupri/dios	group
*kupri/dios	group
*kupri/dios	persName
*kupro/qen	placeName
*kwlia/s	group
*lakwni/s	group
*laqri/h	persName
*lesbia/s	group
*lesbia/s	persName
*lesbia/s	group
*lesbia/s	placeName
*lhtw=|os	placeName
*lhtw=|os	persName
*libusti/s	persName
*ma/leia	persName
*make/tis	persName
*makhdoni/h	placeName
*makhdoni/h	persName
*makhdoni/h	placeName
*markiano/s	persName
*markiano/s	persName
*markiano/s	persName
*melhsago/ras	persName
*menoi/ths	group
*menoi/ths	persName
*mh/deios	group
*mhdofo/nos	persName
*mhdofo/nos	group
*mhdokto/nos	persName
*mhno/filos	persName
*mi/dwn	persName
*mikkali/wn	persName
*moyo/pioi	group
*nai/s	persName
*naiako/s	placeName
*ne/mesis	persName
*neilaieu/s	persName
*neilaieu/s	persName
*neilo/rutos	persName
*neilogenh/s	persName
*neilwi/s	group
*neoklei/dhs	persName
*nisai=os	placeName
*o)lumpia/s	group
*oi)di/pous	group
*ou)dai=os	persName
*paioni/s	placeName
*pandioni/s	persName
*pandw/rh	persName
*pantai/netos	persName
*peri/kleios	persName
*perikalli/maxoi	group
*phgasi\s	placeName
*phgasi\s	persName
*phnelo/ph	group
*pi/shqen	persName
*pieri/s	placeName
*pieriko/s	persName
*pieriko/s	group
*pieriko/s	group
*pieriko/s	group
*pleia/des	group
*plouteu/s	persName
*plouteu/s	persName
*plouteu/s	persName
*polu/nikos	persName
*priamiko/s	placeName
*promh/qeios	persName
*prwto/maxos	persName
*prwto/maxos	persName
*pu/rwn	persName
*qh/bhqen	persName
*qh/bhqen	placeName
*quw/nixos	persName
*salmaki/s	group
*sikani/a	persName
*sikani/a	persName
*sikeli/dhs	persName
*silentia/rios	persName
*skaio/s	placeName
*smu/rnh	placeName
*sodomi=tis	group
*sqenelai/+dhs	placeName
*stoiko/s	group
*suneto/s	persName
*surihgenh/s	persName
*swkratiko/s	group
*swsi/patros	persName
*swsi/patros	persName
*sxeri/a	placeName
*sxeri/a	persName
*tantali/dhs	persName
*tantali/s	persName
*tantali/s	persName
*tantali/s	persName
*tantali/s	persName
*teleutago/ras	persName
*teryixo/rh	persName
*teryixo/rh	persName
*teryixo/rh	persName
*teuqrani/h	persName
*thlebo/hs	group
*thlebo/hs	group
*ti/bios	persName
*tima/nwr	persName
*timo/dhmos	persName
*tituokto/nos	persName
*tlhsime/nhs	persName
*trinakri/a	group
*trinakri/a	persName
*tritw/	persName
*turrhnole/ths	persName
*xai/ris	persName
*xei/lwn	persName
*xei/lwn	persName
*xei/lwn	persName
*xeirwni/s	group
*xoi/rilos	persName
*xoi/rilos	persName
*xristiano/s	persName
*xristiano/s	persName
*xristiano/s	group
*xru/silla	persName
*zhno/frwn	persName
